{
  "1": "१",
  "2": "२",
  "3": "३",
  "4": "४",
  "5": "५",
  "6": "६",
  "7": "७",
  "8": "८",
  "9": "९",
  "0": "०",
  "-": "-",
  "=": "=",
  "q": "ॅ",
  "w": "अ",
  "e": "े",
  "r": "र",
  "t": "त",
  "y": "य",
  "u": "ु",
  "i": "ि",
  "o": "ो",
  "p": "प",
  "[": "॰",
  "]": "₹",
  "\\": "ॊ",
  "a": "ा",
  "s": "स",
  "d": "द",
  "f": "्",
  "g": "ग",
  "h": "ग",
  "j": "ज",
  "k": "क",
  "l": "ल",
  ";": ";",
  "'": "'",
  "z": "ङ",
  "x": "ष",
  "c": "च",
  "v": "व",
  "b": "ब",
  "n": "न",
  "m": "म",
  ",": ",",
  ".": "।",
  "/": "/",
  "!": "!",
  "@": "@",
  "#": "#",
  "$": "$",
  "%": "%",
  "^": "^",
  "&": "&",
  "*": "*",
  "(": "(",
  ")": ")",
  "_": "_",
  "+": "+",
  "Q": "ॉ",
  "W": "आ",
  "E": "ै",
  "R": "ृ",
  "T": "थ",
  "Y": "य़",
  "U": "ू",
  "I": "ी",
  "O": "ौ",
  "P": "फ",
  "{": "[",
  "}": "]",
  "|": "ऒ",
  "A": "ा",
  "S": "श",
  "D": "ध",
  "F": "़",
  "G": "घ",
  "H": "ः",
  "J": "झ",
  "K": "ख",
  "L": "ळ",
  ":": ":",
  "\"": "\"",
  "Z": "ँ",
  "X": "क्ष",
  "C": "छ",
  "V": "",
  "B": "भ",
  "N": "ण",
  "M": "ं",
  "<": "<",
  ">": ">",
  "?": "?"
}
